Цель:
Моя задача — прогнозировать цену продажи каждого дома.
Для каждого идентификатора в тестовом наборе я должен предсказать значение переменной SalePrice.


Поля данных:

SalePrice — цена продажи недвижимости в долларах. Это целевая переменная, которую я пытаюсь предсказать.

MSSubClass: класс здания.

MSZoning: Общая классификация зонирования.

LotFrontage: погонные футы улицы, соединенной с участком.

LotArea: размер участка в квадратных футах.

Street: Тип подъезда к дороге

Alley: Тип доступа к переулку

LotShape: Общий вид объекта недвижимости

LandContour: Ровность участка

Utilities: Типы доступных утилит.

LotConfig: конфигурация лота

LandSlope: Уклон участка

Neighborhood: физические местоположения в пределах города Эймс.

Condition1: Близость к главной дороге или железной дороге.

Condition2: Близость к главной дороге или железной дороге (при наличии второй)

BldgType: Тип жилья

HouseStyle: Стиль жилища

TotalQual: общее качество материала и отделки.

TotalCond: общая оценка состояния.

YearBuilt: дата первоначального строительства.

YearRemodAdd: дата ремоделирования.

RoofStyle: Тип крыши.

RoofMatl: Материал крыши

Exterior1st: Наружное покрытие дома

Exterior2nd: Внешнее покрытие дома (если более одного материала)

MasVnrType: тип каменной облицовки.

MasVnrArea: площадь каменного шпона в квадратных футах.

ExterQual: Качество материалов экстерьера

ExterCond: Текущее состояние материала снаружи.

BsmtQual: Тип фундамента

BsmtQual: Высота подвала.

BsmtCond: Общее состояние подвала.

BsmtExposure: стены подвала на уровне сада или выходного этажа.

BsmtFinType1: Качество готовой площади подвала.

BsmtFinSF1: готовые квадратные футы типа 1.

BsmtFinType2: качество второй готовой площади (если имеется).

BsmtFinSF2: готовые квадратные футы типа 2.

BsmtUnfSF: Недостроенные квадратные футы подвала.

TotalBsmtSF: Общая площадь подвала в квадратных футах.

Heating: Тип отопления

HeatingQC: качество и состояние отопления.

CentralAir: Центральное кондиционирование.

Electrical: Электрическая система

1stFlrSF: квадратные футы первого этажа.

2ndFlrSF: квадратные футы второго этажа.

LowQualFinSF: квадратные футы с отделкой низкого качества (все этажи)

GrLivArea: жилая площадь над землей, квадратные футы.

BsmtFullBath: Полностью оборудованные ванные комнаты в подвале.

BsmtHalfBath: Ванные комнаты в подвале.

FullBath: полностью оборудованные ванные комнаты над уровнем моря.

HalfBath: полуванны выше уровня.

Bedroom: Количество спален над цокольным этажом.

Kitchen: Количество кухонь

KitchenQual: Качество кухни

TotRmsAbvGrd: общее количество комнат выше уровня (без ванных комнат).

Functional: Рейтинг функциональности дома

Fireplaces: Количество каминов

FireplaceQu: Качество камина

GarageType: Расположение гаража

GarageYrBlt: Год постройки гаража.

GarageFinish: Внутренняя отделка гаража.

GarageCars: Размер гаража по вместимости автомобиля.

GarageArea: Размер гаража в квадратных футах.

GarageQual: гаражное качество.

GarageCond: состояние гаража.

PavedDrive: Асфальтированная подъездная дорога

WoodDeckSF: Площадь деревянного настила в квадратных футах.

OpenPorchSF: площадь открытой веранды в квадратных футах.

EnclosedPorch: площадь крытой веранды в квадратных футах.

3SsnPorch: Трехсезонная веранда в квадратных футах

ScreenPorch: площадь веранды в квадратных футах.

PoolArea: площадь бассейна в квадратных футах.

PoolQC: качество бассейна

Fence: Качество забора

MiscFeature: Разные функции, не вошедшие в другие категории.

MiscVal: $Значение различных функций.

MoSold: месяц продажи

YrSold: Год продажи

SaleType: Тип продажи

SaleCondition: Состояние продажи